刄	刃
仭	仞
劔	劒
戶	户
朮	术
令	令
幵	开
倂	併
郉	邢
姸	妍
筓	笄
銒	鈃
幷	并
逬	迸
帲	帡
腁	胼
甁	瓶
塀	塀
輧	軿
糸	糹
呂	吕
吳	吴
爭	争
免	免
彔	录
靑	青
奐	奂
郞	郎
兪	俞
彥	彦
眞	真
旣	既
袞	衮
黃	黄
溫	温
搖	摇
龜	龜
𩙿	飠
飮	飲
飯	飯
飼	飼
館	館
餩	餩